,EventName,Source,GlobalTid,Timestamp,EndTimestamp,SpentTime
0,ZFP_COMPRESS,zfp_rate8_4gpu_10iter-each.json,_282142525397869,507795592,1985272550,1477476958
1,ZFP_DECOMPRESS,zfp_rate8_4gpu_10iter-each.json,_282142525397869,1985535112,1985559004,23892
2,ZFP_COMPRESS,zfp_rate8_4gpu_10iter-each.json,_282142525397869,2280835551,3800235663,1519400112
3,ZFP_DECOMPRESS,zfp_rate8_4gpu_10iter-each.json,_282142525397869,3800506696,3800526192,19496
4,ZFP_COMPRESS,zfp_rate8_4gpu_10iter-each.json,_282142525397869,4095421927,5510172121,1414750194
5,ZFP_DECOMPRESS,zfp_rate8_4gpu_10iter-each.json,_282142525397869,5510429744,5510446533,16789
6,ZFP_COMPRESS,zfp_rate8_4gpu_10iter-each.json,_282142525397869,5804543619,7223475292,1418931673
7,ZFP_DECOMPRESS,zfp_rate8_4gpu_10iter-each.json,_282142525397869,7223740578,7223760054,19476
8,ZFP_COMPRESS,zfp_rate8_4gpu_10iter-each.json,_282142525397869,7322663547,7322740172,76625
9,ZFP_DECOMPRESS,zfp_rate8_4gpu_10iter-each.json,_282142525397869,7322939770,7322957833,18063
10,ZFP_COMPRESS,zfp_rate8_4gpu_10iter-each.json,_282142525397869,7423813308,7423890270,76962
11,ZFP_DECOMPRESS,zfp_rate8_4gpu_10iter-each.json,_282142525397869,7424103809,7424123299,19490
12,ZFP_COMPRESS,zfp_rate8_4gpu_10iter-each.json,_282142525397869,7524603040,7524678825,75785
13,ZFP_DECOMPRESS,zfp_rate8_4gpu_10iter-each.json,_282142525397869,7524888017,7524906145,18128
14,ZFP_COMPRESS,zfp_rate8_4gpu_10iter-each.json,_282142525397869,7684720054,7684796562,76508
15,ZFP_DECOMPRESS,zfp_rate8_4gpu_10iter-each.json,_282142525397869,7685014329,7685032737,18408
16,ZFP_COMPRESS,zfp_rate8_4gpu_10iter-each.json,_282142525397869,7784824490,7784901268,76778
17,ZFP_DECOMPRESS,zfp_rate8_4gpu_10iter-each.json,_282142525397869,7785114061,7785132800,18739
18,ZFP_COMPRESS,zfp_rate8_4gpu_10iter-each.json,_282142525397869,7885170570,7885246302,75732
19,ZFP_DECOMPRESS,zfp_rate8_4gpu_10iter-each.json,_282142525397869,7885463350,7885482220,18870
20,ZFP_COMPRESS,zfp_rate8_4gpu_10iter-each.json,_282142525397869,7984429574,7984503569,73995
21,ZFP_DECOMPRESS,zfp_rate8_4gpu_10iter-each.json,_282142525397869,7984713335,7984731101,17766
22,ZFP_COMPRESS,zfp_rate8_4gpu_10iter-each.json,_282142525397869,8089534003,8089600352,66349
23,ZFP_DECOMPRESS,zfp_rate8_4gpu_10iter-each.json,_282142525397869,8089811308,8089828166,16858
24,ZFP_COMPRESS,zfp_rate8_4gpu_10iter-each.json,_282142525397869,8194243310,8194306845,63535
25,ZFP_DECOMPRESS,zfp_rate8_4gpu_10iter-each.json,_282142525397869,8194514337,8194530822,16485
26,ZFP_COMPRESS,zfp_rate8_4gpu_10iter-each.json,_282142525397869,8286355337,8286418459,63122
27,ZFP_DECOMPRESS,zfp_rate8_4gpu_10iter-each.json,_282142525397869,8286632128,8286648172,16044
28,ZFP_COMPRESS,zfp_rate8_4gpu_10iter-each.json,_282142525397869,8378688606,8378752898,64292
29,ZFP_DECOMPRESS,zfp_rate8_4gpu_10iter-each.json,_282142525397869,8378961116,8378978094,16978
30,ZFP_COMPRESS,zfp_rate8_4gpu_10iter-each.json,_282142525397869,8471955208,8472022755,67547
31,ZFP_DECOMPRESS,zfp_rate8_4gpu_10iter-each.json,_282142525397869,8472239622,8472257599,17977
32,ZFP_COMPRESS,zfp_rate8_4gpu_10iter-each.json,_282142525397869,8564701971,8564765177,63206
33,ZFP_DECOMPRESS,zfp_rate8_4gpu_10iter-each.json,_282142525397869,8564974337,8564989653,15316
34,ZFP_COMPRESS,zfp_rate8_4gpu_10iter-each.json,_282142525397869,8657740914,8657804849,63935
35,ZFP_DECOMPRESS,zfp_rate8_4gpu_10iter-each.json,_282142525397869,8658017884,8658033108,15224
36,ZFP_COMPRESS,zfp_rate8_4gpu_10iter-each.json,_282142525397869,8750236371,8750301004,64633
37,ZFP_DECOMPRESS,zfp_rate8_4gpu_10iter-each.json,_282142525397869,8750507451,8750524221,16770
38,ZFP_COMPRESS,zfp_rate8_4gpu_10iter-each.json,_282142525397869,8842792437,8842860468,68031
39,ZFP_DECOMPRESS,zfp_rate8_4gpu_10iter-each.json,_282142525397869,8843071673,8843093669,21996
40,ZFP_COMPRESS,zfp_rate8_4gpu_10iter-each.json,_282142525397869,8935891745,8935957151,65406
41,ZFP_DECOMPRESS,zfp_rate8_4gpu_10iter-each.json,_282142525397869,8936169653,8936185415,15762
42,ZFP_COMPRESS,zfp_rate8_4gpu_10iter-each.json,_282142525397869,9028317435,9028382007,64572
43,ZFP_DECOMPRESS,zfp_rate8_4gpu_10iter-each.json,_282142525397869,9028594212,9028609421,15209
44,ZFP_COMPRESS,zfp_rate8_4gpu_10iter-each.json,_282142525397869,9120950374,9121018900,68526
45,ZFP_DECOMPRESS,zfp_rate8_4gpu_10iter-each.json,_282142525397869,9121234099,9121252130,18031
46,ZFP_COMPRESS,zfp_rate8_4gpu_10iter-each.json,_282142525397869,9228458012,9228577128,119116
47,ZFP_DECOMPRESS,zfp_rate8_4gpu_10iter-each.json,_282142525397869,9229563317,9229618284,54967
48,ZFP_COMPRESS,zfp_rate8_4gpu_10iter-each.json,_282142525397869,9369595003,9369677825,82822
49,ZFP_DECOMPRESS,zfp_rate8_4gpu_10iter-each.json,_282142525397869,9371074519,9371107137,32618
50,ZFP_COMPRESS,zfp_rate8_4gpu_10iter-each.json,_282142525397869,9493374071,9493456636,82565
51,ZFP_DECOMPRESS,zfp_rate8_4gpu_10iter-each.json,_282142525397869,9494931071,9494983389,52318
52,ZFP_COMPRESS,zfp_rate8_4gpu_10iter-each.json,_282142525397869,9599798544,9599872741,74197
53,ZFP_DECOMPRESS,zfp_rate8_4gpu_10iter-each.json,_282142525397869,9600225535,9600244523,18988
54,ZFP_COMPRESS,zfp_rate8_4gpu_10iter-each.json,_282142525397869,9700103988,9700177680,73692
55,ZFP_DECOMPRESS,zfp_rate8_4gpu_10iter-each.json,_282142525397869,9700820333,9700839003,18670
56,ZFP_COMPRESS,zfp_rate8_4gpu_10iter-each.json,_282142525397869,9800112280,9800189858,77578
57,ZFP_DECOMPRESS,zfp_rate8_4gpu_10iter-each.json,_282142525397869,9800406264,9800424809,18545
58,ZFP_COMPRESS,zfp_rate8_4gpu_10iter-each.json,_282142525397869,9899049307,9899134318,85011
59,ZFP_DECOMPRESS,zfp_rate8_4gpu_10iter-each.json,_282142525397869,9899360854,9899379843,18989
60,ZFP_COMPRESS,zfp_rate8_4gpu_10iter-each.json,_282142525397869,9998159870,9998234641,74771
61,ZFP_DECOMPRESS,zfp_rate8_4gpu_10iter-each.json,_282142525397869,9998453938,9998472247,18309
62,ZFP_COMPRESS,zfp_rate8_4gpu_10iter-each.json,_282142525397869,10097382410,10097457102,74692
63,ZFP_DECOMPRESS,zfp_rate8_4gpu_10iter-each.json,_282142525397869,10097660449,10097677816,17367
64,ZFP_COMPRESS,zfp_rate8_4gpu_10iter-each.json,_282142525397869,10195551679,10195626122,74443
65,ZFP_DECOMPRESS,zfp_rate8_4gpu_10iter-each.json,_282142525397869,10195833341,10195850926,17585
66,ZFP_COMPRESS,zfp_rate8_4gpu_10iter-each.json,_282142525397869,10293197167,10293274865,77698
67,ZFP_DECOMPRESS,zfp_rate8_4gpu_10iter-each.json,_282142525397869,10293487199,10293505918,18719
68,ZFP_COMPRESS,zfp_rate8_4gpu_10iter-each.json,_282142525397869,10390195478,10390269495,74017
69,ZFP_DECOMPRESS,zfp_rate8_4gpu_10iter-each.json,_282142525397869,10390470222,10390487255,17033
70,ZFP_COMPRESS,zfp_rate8_4gpu_10iter-each.json,_282142525397869,10486085261,10486168568,83307
71,ZFP_DECOMPRESS,zfp_rate8_4gpu_10iter-each.json,_282142525397869,10486749162,10486767585,18423
72,ZFP_COMPRESS,zfp_rate8_4gpu_10iter-each.json,_282142525397869,10582767945,10582843118,75173
73,ZFP_DECOMPRESS,zfp_rate8_4gpu_10iter-each.json,_282142525397869,10583041850,10583060924,19074
74,ZFP_COMPRESS,zfp_rate8_4gpu_10iter-each.json,_282142525397869,10680033600,10680113896,80296
75,ZFP_DECOMPRESS,zfp_rate8_4gpu_10iter-each.json,_282142525397869,10680365061,10680390473,25412
76,ZFP_COMPRESS,zfp_rate8_4gpu_10iter-each.json,_282142525397869,10776773887,10776845587,71700
77,ZFP_DECOMPRESS,zfp_rate8_4gpu_10iter-each.json,_282142525397869,10777042541,10777060129,17588
78,ZFP_COMPRESS,zfp_rate8_4gpu_10iter-each.json,_282142525397869,10874012025,10874084130,72105
79,ZFP_DECOMPRESS,zfp_rate8_4gpu_10iter-each.json,_282142525397869,10874297745,10874315933,18188
80,ZFP_COMPRESS,zfp_rate4_4gpu_10iter-each.json,_282583766204969,497796655,1974544197,1476747542
81,ZFP_DECOMPRESS,zfp_rate4_4gpu_10iter-each.json,_282583766204969,1974799044,1974822466,23422
82,ZFP_COMPRESS,zfp_rate4_4gpu_10iter-each.json,_282583766204969,2255418792,3788633698,1533214906
83,ZFP_DECOMPRESS,zfp_rate4_4gpu_10iter-each.json,_282583766204969,3788905007,3788921384,16377
84,ZFP_COMPRESS,zfp_rate4_4gpu_10iter-each.json,_282583766204969,4067209670,5464052885,1396843215
85,ZFP_DECOMPRESS,zfp_rate4_4gpu_10iter-each.json,_282583766204969,5464334001,5464353394,19393
86,ZFP_COMPRESS,zfp_rate4_4gpu_10iter-each.json,_282583766204969,5746892727,7146260376,1399367649
87,ZFP_DECOMPRESS,zfp_rate4_4gpu_10iter-each.json,_282583766204969,7146540548,7146560557,20009
88,ZFP_COMPRESS,zfp_rate4_4gpu_10iter-each.json,_282583766204969,7245414087,7245498311,84224
89,ZFP_DECOMPRESS,zfp_rate4_4gpu_10iter-each.json,_282583766204969,7245699154,7245714701,15547
90,ZFP_COMPRESS,zfp_rate4_4gpu_10iter-each.json,_282583766204969,7344987356,7345066289,78933
91,ZFP_DECOMPRESS,zfp_rate4_4gpu_10iter-each.json,_282583766204969,7345272065,7345288548,16483
92,ZFP_COMPRESS,zfp_rate4_4gpu_10iter-each.json,_282583766204969,7443303366,7443382675,79309
93,ZFP_DECOMPRESS,zfp_rate4_4gpu_10iter-each.json,_282583766204969,7443586430,7443602504,16074
94,ZFP_COMPRESS,zfp_rate4_4gpu_10iter-each.json,_282583766204969,7541895922,7541972373,76451
95,ZFP_DECOMPRESS,zfp_rate4_4gpu_10iter-each.json,_282583766204969,7542167425,7542182116,14691
96,ZFP_COMPRESS,zfp_rate4_4gpu_10iter-each.json,_282583766204969,7640040855,7640120656,79801
97,ZFP_DECOMPRESS,zfp_rate4_4gpu_10iter-each.json,_282583766204969,7640317489,7640333314,15825
98,ZFP_COMPRESS,zfp_rate4_4gpu_10iter-each.json,_282583766204969,7738020176,7738101021,80845
99,ZFP_DECOMPRESS,zfp_rate4_4gpu_10iter-each.json,_282583766204969,7738305515,7738321300,15785
100,ZFP_COMPRESS,zfp_rate4_4gpu_10iter-each.json,_282583766204969,7836868577,7836947069,78492
101,ZFP_DECOMPRESS,zfp_rate4_4gpu_10iter-each.json,_282583766204969,7837144363,7837161018,16655
102,ZFP_COMPRESS,zfp_rate4_4gpu_10iter-each.json,_282583766204969,7935049842,7935128565,78723
103,ZFP_DECOMPRESS,zfp_rate4_4gpu_10iter-each.json,_282583766204969,7935324676,7935339715,15039
104,ZFP_COMPRESS,zfp_rate4_4gpu_10iter-each.json,_282583766204969,8033201759,8033281343,79584
105,ZFP_DECOMPRESS,zfp_rate4_4gpu_10iter-each.json,_282583766204969,8033480604,8033502695,22091
106,ZFP_COMPRESS,zfp_rate4_4gpu_10iter-each.json,_282583766204969,8131498535,8131576000,77465
107,ZFP_DECOMPRESS,zfp_rate4_4gpu_10iter-each.json,_282583766204969,8131783006,8131800099,17093
108,ZFP_COMPRESS,zfp_rate4_4gpu_10iter-each.json,_282583766204969,8229584006,8229662881,78875
109,ZFP_DECOMPRESS,zfp_rate4_4gpu_10iter-each.json,_282583766204969,8229859707,8229876437,16730
110,ZFP_COMPRESS,zfp_rate4_4gpu_10iter-each.json,_282583766204969,8328100701,8328176638,75937
111,ZFP_DECOMPRESS,zfp_rate4_4gpu_10iter-each.json,_282583766204969,8328377051,8328398965,21914
112,ZFP_COMPRESS,zfp_rate4_4gpu_10iter-each.json,_282583766204969,8426034222,8426111717,77495
113,ZFP_DECOMPRESS,zfp_rate4_4gpu_10iter-each.json,_282583766204969,8426308603,8426324031,15428
114,ZFP_COMPRESS,zfp_rate4_4gpu_10iter-each.json,_282583766204969,8524291293,8524372479,81186
115,ZFP_DECOMPRESS,zfp_rate4_4gpu_10iter-each.json,_282583766204969,8524590238,8524610121,19883
116,ZFP_COMPRESS,zfp_rate4_4gpu_10iter-each.json,_282583766204969,8622362546,8622439546,77000
117,ZFP_DECOMPRESS,zfp_rate4_4gpu_10iter-each.json,_282583766204969,8622643438,8622659968,16530
118,ZFP_COMPRESS,zfp_rate4_4gpu_10iter-each.json,_282583766204969,8720023493,8720100452,76959
119,ZFP_DECOMPRESS,zfp_rate4_4gpu_10iter-each.json,_282583766204969,8720299408,8720317910,18502
120,ZFP_COMPRESS,zfp_rate4_4gpu_10iter-each.json,_282583766204969,8817642820,8817719534,76714
121,ZFP_DECOMPRESS,zfp_rate4_4gpu_10iter-each.json,_282583766204969,8817917643,8817933104,15461
122,ZFP_COMPRESS,zfp_rate4_4gpu_10iter-each.json,_282583766204969,8915793218,8915881461,88243
123,ZFP_DECOMPRESS,zfp_rate4_4gpu_10iter-each.json,_282583766204969,8916105348,8916126955,21607
124,ZFP_COMPRESS,zfp_rate4_4gpu_10iter-each.json,_282583766204969,9014343530,9014432606,89076
125,ZFP_DECOMPRESS,zfp_rate4_4gpu_10iter-each.json,_282583766204969,9014642892,9014661906,19014
126,ZFP_COMPRESS,zfp_rate4_4gpu_10iter-each.json,_282583766204969,9112579192,9112654882,75690
127,ZFP_DECOMPRESS,zfp_rate4_4gpu_10iter-each.json,_282583766204969,9112853681,9112879736,26055
128,ZFP_COMPRESS,zfp_rate4_4gpu_10iter-each.json,_282583766204969,9210585538,9210661356,75818
129,ZFP_DECOMPRESS,zfp_rate4_4gpu_10iter-each.json,_282583766204969,9210861340,9210877462,16122
130,ZFP_COMPRESS,zfp_rate4_4gpu_10iter-each.json,_282583766204969,9308809612,9308887029,77417
131,ZFP_DECOMPRESS,zfp_rate4_4gpu_10iter-each.json,_282583766204969,9309092235,9309115409,23174
132,ZFP_COMPRESS,zfp_rate4_4gpu_10iter-each.json,_282583766204969,9412577915,9412656353,78438
133,ZFP_DECOMPRESS,zfp_rate4_4gpu_10iter-each.json,_282583766204969,9412854313,9412871479,17166
134,ZFP_COMPRESS,zfp_rate4_4gpu_10iter-each.json,_282583766204969,9510501152,9510584494,83342
135,ZFP_DECOMPRESS,zfp_rate4_4gpu_10iter-each.json,_282583766204969,9510782515,9510798537,16022
136,ZFP_COMPRESS,zfp_rate4_4gpu_10iter-each.json,_282583766204969,9608523020,9608597061,74041
137,ZFP_DECOMPRESS,zfp_rate4_4gpu_10iter-each.json,_282583766204969,9608798450,9608814333,15883
138,ZFP_COMPRESS,zfp_rate4_4gpu_10iter-each.json,_282583766204969,9706632495,9706716175,83680
139,ZFP_DECOMPRESS,zfp_rate4_4gpu_10iter-each.json,_282583766204969,9706922134,9706937856,15722
140,ZFP_COMPRESS,zfp_rate4_4gpu_10iter-each.json,_282583766204969,9804721628,9804798344,76716
141,ZFP_DECOMPRESS,zfp_rate4_4gpu_10iter-each.json,_282583766204969,9804997156,9805013337,16181
142,ZFP_COMPRESS,zfp_rate4_4gpu_10iter-each.json,_282583766204969,9902762533,9902844625,82092
143,ZFP_DECOMPRESS,zfp_rate4_4gpu_10iter-each.json,_282583766204969,9903044303,9903059105,14802
144,ZFP_COMPRESS,zfp_rate4_4gpu_10iter-each.json,_282583766204969,10000838767,10000914891,76124
145,ZFP_DECOMPRESS,zfp_rate4_4gpu_10iter-each.json,_282583766204969,10001117033,10001132798,15765
146,ZFP_COMPRESS,zfp_rate4_4gpu_10iter-each.json,_282583766204969,10098898852,10098982998,84146
147,ZFP_DECOMPRESS,zfp_rate4_4gpu_10iter-each.json,_282583766204969,10099193289,10099209837,16548
148,ZFP_COMPRESS,zfp_rate4_4gpu_10iter-each.json,_282583766204969,10196802988,10196881374,78386
149,ZFP_DECOMPRESS,zfp_rate4_4gpu_10iter-each.json,_282583766204969,10197078208,10197095028,16820
150,ZFP_COMPRESS,zfp_rate4_4gpu_10iter-each.json,_282583766204969,10294831530,10294913777,82247
151,ZFP_DECOMPRESS,zfp_rate4_4gpu_10iter-each.json,_282583766204969,10295112411,10295127694,15283
152,ZFP_COMPRESS,zfp_rate4_4gpu_10iter-each.json,_282583766204969,10392608548,10392688787,80239
153,ZFP_DECOMPRESS,zfp_rate4_4gpu_10iter-each.json,_282583766204969,10392892301,10392908956,16655
154,ZFP_COMPRESS,zfp_rate4_4gpu_10iter-each.json,_282583766204969,10490713203,10490796759,83556
155,ZFP_DECOMPRESS,zfp_rate4_4gpu_10iter-each.json,_282583766204969,10491003502,10491020108,16606
156,ZFP_COMPRESS,zfp_rate4_4gpu_10iter-each.json,_282583766204969,10588541536,10588620354,78818
157,ZFP_DECOMPRESS,zfp_rate4_4gpu_10iter-each.json,_282583766204969,10588818970,10588836737,17767
158,ZFP_COMPRESS,zfp_rate4_4gpu_10iter-each.json,_282583766204969,10686671391,10686752600,81209
159,ZFP_DECOMPRESS,zfp_rate4_4gpu_10iter-each.json,_282583766204969,10686956440,10686971994,15554
160,CUSZ_COMPRESS,cusz_r2r_4gpu_10iter-each.json,_281955224547281,3881652050,6063471293,2181819243
161,CUSZ_DECOMPRESS,cusz_r2r_4gpu_10iter-each.json,_281955224547281,6065602479,6071206613,5604134
162,CUSZ_COMPRESS,cusz_r2r_4gpu_10iter-each.json,_281955224547281,9605139431,9855463733,250324302
163,CUSZ_DECOMPRESS,cusz_r2r_4gpu_10iter-each.json,_281955224547281,9857796662,9863603120,5806458
164,CUSZ_COMPRESS,cusz_r2r_4gpu_10iter-each.json,_281955224547281,13459445422,13722513319,263067897
165,CUSZ_DECOMPRESS,cusz_r2r_4gpu_10iter-each.json,_281955224547281,13724993555,13730956137,5962582
166,CUSZ_COMPRESS,cusz_r2r_4gpu_10iter-each.json,_281955224547281,17257616424,17500376887,242760463
167,CUSZ_DECOMPRESS,cusz_r2r_4gpu_10iter-each.json,_281955224547281,17503146263,17509296074,6149811
168,CUSZ_COMPRESS,cusz_r2r_4gpu_10iter-each.json,_281955224547281,17583963636,17590606910,6643274
169,CUSZ_DECOMPRESS,cusz_r2r_4gpu_10iter-each.json,_281955224547281,17592902760,17598562931,5660171
170,CUSZ_COMPRESS,cusz_r2r_4gpu_10iter-each.json,_281955224547281,17671631234,17678293515,6662281
171,CUSZ_DECOMPRESS,cusz_r2r_4gpu_10iter-each.json,_281955224547281,17680617102,17686227331,5610229
172,CUSZ_COMPRESS,cusz_r2r_4gpu_10iter-each.json,_281955224547281,17759870860,17766557028,6686168
173,CUSZ_DECOMPRESS,cusz_r2r_4gpu_10iter-each.json,_281955224547281,17768845934,17774525615,5679681
174,CUSZ_COMPRESS,cusz_r2r_4gpu_10iter-each.json,_281955224547281,17850656594,17857839819,7183225
175,CUSZ_DECOMPRESS,cusz_r2r_4gpu_10iter-each.json,_281955224547281,17860272502,17866300792,6028290
176,CUSZ_COMPRESS,cusz_r2r_4gpu_10iter-each.json,_281955224547281,17943756787,17950403307,6646520
177,CUSZ_DECOMPRESS,cusz_r2r_4gpu_10iter-each.json,_281955224547281,17952707178,17958605819,5898641
178,CUSZ_COMPRESS,cusz_r2r_4gpu_10iter-each.json,_281955224547281,18034265741,18040909344,6643603
179,CUSZ_DECOMPRESS,cusz_r2r_4gpu_10iter-each.json,_281955224547281,18043194714,18049080609,5885895
180,CUSZ_COMPRESS,cusz_r2r_4gpu_10iter-each.json,_281955224547281,18124577213,18131338286,6761073
181,CUSZ_DECOMPRESS,cusz_r2r_4gpu_10iter-each.json,_281955224547281,18133655732,18139579566,5923834
182,CUSZ_COMPRESS,cusz_r2r_4gpu_10iter-each.json,_281955224547281,18216121067,18222828696,6707629
183,CUSZ_DECOMPRESS,cusz_r2r_4gpu_10iter-each.json,_281955224547281,18225188630,18231138776,5950146
184,CUSZ_COMPRESS,cusz_r2r_4gpu_10iter-each.json,_281955224547281,18306320967,18313249331,6928364
185,CUSZ_DECOMPRESS,cusz_r2r_4gpu_10iter-each.json,_281955224547281,18315527252,18321359139,5831887
186,CUSZ_COMPRESS,cusz_r2r_4gpu_10iter-each.json,_281955224547281,18396275348,18402864657,6589309
187,CUSZ_DECOMPRESS,cusz_r2r_4gpu_10iter-each.json,_281955224547281,18405131784,18410963480,5831696
188,CUSZ_COMPRESS,cusz_r2r_4gpu_10iter-each.json,_281955224547281,18487695015,18494419367,6724352
189,CUSZ_DECOMPRESS,cusz_r2r_4gpu_10iter-each.json,_281955224547281,18496739466,18502687353,5947887
190,CUSZ_COMPRESS,cusz_r2r_4gpu_10iter-each.json,_281955224547281,18576800030,18583548679,6748649
191,CUSZ_DECOMPRESS,cusz_r2r_4gpu_10iter-each.json,_281955224547281,18585917308,18591894153,5976845
192,CUSZ_COMPRESS,cusz_r2r_4gpu_10iter-each.json,_281955224547281,18666088076,18672725848,6637772
193,CUSZ_DECOMPRESS,cusz_r2r_4gpu_10iter-each.json,_281955224547281,18674997548,18680888096,5890548
194,CUSZ_COMPRESS,cusz_r2r_4gpu_10iter-each.json,_281955224547281,18755402855,18762048997,6646142
195,CUSZ_DECOMPRESS,cusz_r2r_4gpu_10iter-each.json,_281955224547281,18764378542,18770273842,5895300
196,CUSZ_COMPRESS,cusz_r2r_4gpu_10iter-each.json,_281955224547281,18845809655,18852473536,6663881
197,CUSZ_DECOMPRESS,cusz_r2r_4gpu_10iter-each.json,_281955224547281,18854832914,18860710309,5877395
198,CUSZ_COMPRESS,cusz_r2r_4gpu_10iter-each.json,_281955224547281,18935925344,18942619777,6694433
199,CUSZ_DECOMPRESS,cusz_r2r_4gpu_10iter-each.json,_281955224547281,18944946312,18950890843,5944531
200,CUSZ_COMPRESS,cusz_r2r_4gpu_10iter-each.json,_281955224547281,19025849609,19032641438,6791829
201,CUSZ_DECOMPRESS,cusz_r2r_4gpu_10iter-each.json,_281955224547281,19034962831,19040905651,5942820
202,CUSZ_COMPRESS,cusz_r2r_4gpu_10iter-each.json,_281955224547281,19116694615,19123318629,6624014
203,CUSZ_DECOMPRESS,cusz_r2r_4gpu_10iter-each.json,_281955224547281,19125592104,19131460710,5868606
204,CUSZ_COMPRESS,cusz_r2r_4gpu_10iter-each.json,_281955224547281,19206476430,19213190258,6713828
205,CUSZ_DECOMPRESS,cusz_r2r_4gpu_10iter-each.json,_281955224547281,19215465143,19221390248,5925105
206,CUSZ_COMPRESS,cusz_r2r_4gpu_10iter-each.json,_281955224547281,19296034192,19302776764,6742572
207,CUSZ_DECOMPRESS,cusz_r2r_4gpu_10iter-each.json,_281955224547281,19305107207,19310995991,5888784
208,CUSZ_COMPRESS,cusz_r2r_4gpu_10iter-each.json,_281955224547281,19388417675,19395169574,6751899
209,CUSZ_DECOMPRESS,cusz_r2r_4gpu_10iter-each.json,_281955224547281,19397493414,19403433384,5939970
210,CUSZ_COMPRESS,cusz_r2r_4gpu_10iter-each.json,_281955224547281,19479188510,19485986034,6797524
211,CUSZ_DECOMPRESS,cusz_r2r_4gpu_10iter-each.json,_281955224547281,19488306039,19494112269,5806230
212,CUSZ_COMPRESS,cusz_r2r_4gpu_10iter-each.json,_281955224547281,19569012246,19575721865,6709619
213,CUSZ_DECOMPRESS,cusz_r2r_4gpu_10iter-each.json,_281955224547281,19578006456,19583998851,5992395
214,CUSZ_COMPRESS,cusz_r2r_4gpu_10iter-each.json,_281955224547281,19658897055,19665623733,6726678
215,CUSZ_DECOMPRESS,cusz_r2r_4gpu_10iter-each.json,_281955224547281,19667988966,19673957053,5968087
216,CUSZ_COMPRESS,cusz_r2r_4gpu_10iter-each.json,_281955224547281,19748691796,19755350700,6658904
217,CUSZ_DECOMPRESS,cusz_r2r_4gpu_10iter-each.json,_281955224547281,19757711165,19763531037,5819872
218,CUSZ_COMPRESS,cusz_r2r_4gpu_10iter-each.json,_281955224547281,19838005474,19844638516,6633042
219,CUSZ_DECOMPRESS,cusz_r2r_4gpu_10iter-each.json,_281955224547281,19846900750,19852788647,5887897
220,CUSZ_COMPRESS,cusz_r2r_4gpu_10iter-each.json,_281955224547281,19926796809,19933595466,6798657
221,CUSZ_DECOMPRESS,cusz_r2r_4gpu_10iter-each.json,_281955224547281,19935933561,19941902202,5968641
222,CUSZ_COMPRESS,cusz_r2r_4gpu_10iter-each.json,_281955224547281,20017040906,20023710526,6669620
223,CUSZ_DECOMPRESS,cusz_r2r_4gpu_10iter-each.json,_281955224547281,20026002282,20031887209,5884927
224,CUSZ_COMPRESS,cusz_r2r_4gpu_10iter-each.json,_281955224547281,20106462070,20113158837,6696767
225,CUSZ_DECOMPRESS,cusz_r2r_4gpu_10iter-each.json,_281955224547281,20115469507,20121193799,5724292
226,CUSZ_COMPRESS,cusz_r2r_4gpu_10iter-each.json,_281955224547281,20195044066,20201623391,6579325
227,CUSZ_DECOMPRESS,cusz_r2r_4gpu_10iter-each.json,_281955224547281,20203869917,20209766981,5897064
228,CUSZ_COMPRESS,cusz_r2r_4gpu_10iter-each.json,_281955224547281,20283641541,20290355765,6714224
229,CUSZ_DECOMPRESS,cusz_r2r_4gpu_10iter-each.json,_281955224547281,20292671298,20298613023,5941725
230,CUSZ_COMPRESS,cusz_r2r_4gpu_10iter-each.json,_281955224547281,20373523247,20380234691,6711444
231,CUSZ_DECOMPRESS,cusz_r2r_4gpu_10iter-each.json,_281955224547281,20382543544,20388609189,6065645
232,CUSZ_COMPRESS,cusz_r2r_4gpu_10iter-each.json,_281955224547281,20465317212,20472108380,6791168
233,CUSZ_DECOMPRESS,cusz_r2r_4gpu_10iter-each.json,_281955224547281,20474434172,20480373428,5939256
234,CUSZ_COMPRESS,cusz_r2r_4gpu_10iter-each.json,_281955224547281,20555064284,20562164926,7100642
235,CUSZ_DECOMPRESS,cusz_r2r_4gpu_10iter-each.json,_281955224547281,20564485414,20570386988,5901574
236,CUSZ_COMPRESS,cusz_r2r_4gpu_10iter-each.json,_281955224547281,20645058013,20651827350,6769337
237,CUSZ_DECOMPRESS,cusz_r2r_4gpu_10iter-each.json,_281955224547281,20654164568,20660007147,5842579
238,CUSZ_COMPRESS,cusz_r2r_4gpu_10iter-each.json,_281955224547281,20735087146,20741920067,6832921
239,CUSZ_DECOMPRESS,cusz_r2r_4gpu_10iter-each.json,_281955224547281,20744317674,20750147069,5829395
240,CUSZ_COMPRESS,cusz_abs_4gpu_10iter-each.json,_281904926450715,3798938439,5959794578,2160856139
241,CUSZ_DECOMPRESS,cusz_abs_4gpu_10iter-each.json,_281904926450715,5962002102,5966693562,4691460
242,CUSZ_COMPRESS,cusz_abs_4gpu_10iter-each.json,_281904926450715,9569251142,9825954662,256703520
243,CUSZ_DECOMPRESS,cusz_abs_4gpu_10iter-each.json,_281904926450715,9828119077,9832832645,4713568
244,CUSZ_COMPRESS,cusz_abs_4gpu_10iter-each.json,_281904926450715,13352994969,13601673038,248678069
245,CUSZ_DECOMPRESS,cusz_abs_4gpu_10iter-each.json,_281904926450715,13604059802,13609002413,4942611
246,CUSZ_COMPRESS,cusz_abs_4gpu_10iter-each.json,_281904926450715,17238286696,17478625458,240338762
247,CUSZ_DECOMPRESS,cusz_abs_4gpu_10iter-each.json,_281904926450715,17481115517,17486280321,5164804
248,CUSZ_COMPRESS,cusz_abs_4gpu_10iter-each.json,_281904926450715,17559469404,17566079920,6610516
249,CUSZ_DECOMPRESS,cusz_abs_4gpu_10iter-each.json,_281904926450715,17568421978,17573422345,5000367
250,CUSZ_COMPRESS,cusz_abs_4gpu_10iter-each.json,_281904926450715,17646496340,17653031571,6535231
251,CUSZ_DECOMPRESS,cusz_abs_4gpu_10iter-each.json,_281904926450715,17655292769,17660035641,4742872
252,CUSZ_COMPRESS,cusz_abs_4gpu_10iter-each.json,_281904926450715,17733143437,17739644542,6501105
253,CUSZ_DECOMPRESS,cusz_abs_4gpu_10iter-each.json,_281904926450715,17741950167,17746668967,4718800
254,CUSZ_COMPRESS,cusz_abs_4gpu_10iter-each.json,_281904926450715,17819847303,17826370980,6523677
255,CUSZ_DECOMPRESS,cusz_abs_4gpu_10iter-each.json,_281904926450715,17828668609,17833370497,4701888
256,CUSZ_COMPRESS,cusz_abs_4gpu_10iter-each.json,_281904926450715,17906811554,17913364951,6553397
257,CUSZ_DECOMPRESS,cusz_abs_4gpu_10iter-each.json,_281904926450715,17915674616,17920401770,4727154
258,CUSZ_COMPRESS,cusz_abs_4gpu_10iter-each.json,_281904926450715,17993512321,18000005542,6493221
259,CUSZ_DECOMPRESS,cusz_abs_4gpu_10iter-each.json,_281904926450715,18002261772,18006996338,4734566
260,CUSZ_COMPRESS,cusz_abs_4gpu_10iter-each.json,_281904926450715,18080078584,18088899748,8821164
261,CUSZ_DECOMPRESS,cusz_abs_4gpu_10iter-each.json,_281904926450715,18091175551,18095843438,4667887
262,CUSZ_COMPRESS,cusz_abs_4gpu_10iter-each.json,_281904926450715,18168475868,18174932283,6456415
263,CUSZ_DECOMPRESS,cusz_abs_4gpu_10iter-each.json,_281904926450715,18177184168,18181898240,4714072
264,CUSZ_COMPRESS,cusz_abs_4gpu_10iter-each.json,_281904926450715,18254778342,18261330051,6551709
265,CUSZ_DECOMPRESS,cusz_abs_4gpu_10iter-each.json,_281904926450715,18263640713,18268550032,4909319
266,CUSZ_COMPRESS,cusz_abs_4gpu_10iter-each.json,_281904926450715,18342217869,18348714954,6497085
267,CUSZ_DECOMPRESS,cusz_abs_4gpu_10iter-each.json,_281904926450715,18350959296,18355839594,4880298
268,CUSZ_COMPRESS,cusz_abs_4gpu_10iter-each.json,_281904926450715,18430779316,18437249297,6469981
269,CUSZ_DECOMPRESS,cusz_abs_4gpu_10iter-each.json,_281904926450715,18439484161,18444349787,4865626
270,CUSZ_COMPRESS,cusz_abs_4gpu_10iter-each.json,_281904926450715,18518270477,18524820138,6549661
271,CUSZ_DECOMPRESS,cusz_abs_4gpu_10iter-each.json,_281904926450715,18527101373,18532015800,4914427
272,CUSZ_COMPRESS,cusz_abs_4gpu_10iter-each.json,_281904926450715,18604923374,18611544624,6621250
273,CUSZ_DECOMPRESS,cusz_abs_4gpu_10iter-each.json,_281904926450715,18613887154,18618823640,4936486
274,CUSZ_COMPRESS,cusz_abs_4gpu_10iter-each.json,_281904926450715,18691269565,18697793690,6524125
275,CUSZ_DECOMPRESS,cusz_abs_4gpu_10iter-each.json,_281904926450715,18700072817,18704973083,4900266
276,CUSZ_COMPRESS,cusz_abs_4gpu_10iter-each.json,_281904926450715,18777651142,18784144430,6493288
277,CUSZ_DECOMPRESS,cusz_abs_4gpu_10iter-each.json,_281904926450715,18786424646,18791294670,4870024
278,CUSZ_COMPRESS,cusz_abs_4gpu_10iter-each.json,_281904926450715,18864136568,18870653077,6516509
279,CUSZ_DECOMPRESS,cusz_abs_4gpu_10iter-each.json,_281904926450715,18872962942,18877865742,4902800
280,CUSZ_COMPRESS,cusz_abs_4gpu_10iter-each.json,_281904926450715,18950629608,18957161322,6531714
281,CUSZ_DECOMPRESS,cusz_abs_4gpu_10iter-each.json,_281904926450715,18959464252,18964376863,4912611
282,CUSZ_COMPRESS,cusz_abs_4gpu_10iter-each.json,_281904926450715,19037250723,19043759223,6508500
283,CUSZ_DECOMPRESS,cusz_abs_4gpu_10iter-each.json,_281904926450715,19046036542,19050995929,4959387
284,CUSZ_COMPRESS,cusz_abs_4gpu_10iter-each.json,_281904926450715,19123832408,19130402762,6570354
285,CUSZ_DECOMPRESS,cusz_abs_4gpu_10iter-each.json,_281904926450715,19132685232,19137531119,4845887
286,CUSZ_COMPRESS,cusz_abs_4gpu_10iter-each.json,_281904926450715,19210291353,19216763554,6472201
287,CUSZ_DECOMPRESS,cusz_abs_4gpu_10iter-each.json,_281904926450715,19219017433,19223966229,4948796
288,CUSZ_COMPRESS,cusz_abs_4gpu_10iter-each.json,_281904926450715,19298035138,19304629263,6594125
289,CUSZ_DECOMPRESS,cusz_abs_4gpu_10iter-each.json,_281904926450715,19306932389,19311862616,4930227
290,CUSZ_COMPRESS,cusz_abs_4gpu_10iter-each.json,_281904926450715,19384196411,19390751690,6555279
291,CUSZ_DECOMPRESS,cusz_abs_4gpu_10iter-each.json,_281904926450715,19393001565,19397936522,4934957
292,CUSZ_COMPRESS,cusz_abs_4gpu_10iter-each.json,_281904926450715,19470360245,19476893539,6533294
293,CUSZ_DECOMPRESS,cusz_abs_4gpu_10iter-each.json,_281904926450715,19479149867,19483868404,4718537
294,CUSZ_COMPRESS,cusz_abs_4gpu_10iter-each.json,_281904926450715,19555651725,19562140736,6489011
295,CUSZ_DECOMPRESS,cusz_abs_4gpu_10iter-each.json,_281904926450715,19564395819,19569197784,4801965
296,CUSZ_COMPRESS,cusz_abs_4gpu_10iter-each.json,_281904926450715,19641517957,19648164788,6646831
297,CUSZ_DECOMPRESS,cusz_abs_4gpu_10iter-each.json,_281904926450715,19650483173,19655255187,4772014
298,CUSZ_COMPRESS,cusz_abs_4gpu_10iter-each.json,_281904926450715,19727464502,19734004324,6539822
299,CUSZ_DECOMPRESS,cusz_abs_4gpu_10iter-each.json,_281904926450715,19736263966,19741023532,4759566
300,CUSZ_COMPRESS,cusz_abs_4gpu_10iter-each.json,_281904926450715,19813119570,19819615271,6495701
301,CUSZ_DECOMPRESS,cusz_abs_4gpu_10iter-each.json,_281904926450715,19821876103,19826633373,4757270
302,CUSZ_COMPRESS,cusz_abs_4gpu_10iter-each.json,_281904926450715,19898689553,19905198193,6508640
303,CUSZ_DECOMPRESS,cusz_abs_4gpu_10iter-each.json,_281904926450715,19907492946,19912207420,4714474
304,CUSZ_COMPRESS,cusz_abs_4gpu_10iter-each.json,_281904926450715,19984565223,19991169363,6604140
305,CUSZ_DECOMPRESS,cusz_abs_4gpu_10iter-each.json,_281904926450715,19993450244,19998213948,4763704
306,CUSZ_COMPRESS,cusz_abs_4gpu_10iter-each.json,_281904926450715,20070494347,20077070537,6576190
307,CUSZ_DECOMPRESS,cusz_abs_4gpu_10iter-each.json,_281904926450715,20079330346,20084095038,4764692
308,CUSZ_COMPRESS,cusz_abs_4gpu_10iter-each.json,_281904926450715,20156491998,20163014220,6522222
309,CUSZ_DECOMPRESS,cusz_abs_4gpu_10iter-each.json,_281904926450715,20165304211,20170040621,4736410
310,CUSZ_COMPRESS,cusz_abs_4gpu_10iter-each.json,_281904926450715,20243528704,20250023797,6495093
311,CUSZ_DECOMPRESS,cusz_abs_4gpu_10iter-each.json,_281904926450715,20252299918,20257058810,4758892
312,CUSZ_COMPRESS,cusz_abs_4gpu_10iter-each.json,_281904926450715,20328780502,20335356186,6575684
313,CUSZ_DECOMPRESS,cusz_abs_4gpu_10iter-each.json,_281904926450715,20337650266,20342414302,4764036
314,CUSZ_COMPRESS,cusz_abs_4gpu_10iter-each.json,_281904926450715,20414326347,20420894418,6568071
315,CUSZ_DECOMPRESS,cusz_abs_4gpu_10iter-each.json,_281904926450715,20423185547,20427960864,4775317
316,CUSZ_COMPRESS,cusz_abs_4gpu_10iter-each.json,_281904926450715,20499584544,20506129557,6545013
317,CUSZ_DECOMPRESS,cusz_abs_4gpu_10iter-each.json,_281904926450715,20508394058,20513143268,4749210
318,CUSZ_COMPRESS,cusz_abs_4gpu_10iter-each.json,_281904926450715,20586034339,20592515172,6480833
319,CUSZ_DECOMPRESS,cusz_abs_4gpu_10iter-each.json,_281904926450715,20594791027,20599682356,4891329
